NO ./textures/N.xpm
SO ./textures/S.xpm
WE ./textures/W.xpm
EA ./textures/E.xpm
F 110,110,110
C 168,230,213

1111111111111111111111111
10000000001100000000S0001
1011000001110000000000011
10010000000D000000000000111111111
111111111011000001110000000000001
100000000011000001110111111111111
11110111111111 D11100000010001
111101111111110111010100100011
1100000011 0101011100000010001
100000000000000011000000100011
10000000000000001101010010001
1100000111010101111101111000111
11110111 1110101 101111010001
11111111 1111111 111111111111
